s f b f f b f f f f  
b f b b f b f b b f  
b f f f f f f b f f  
b f b b b f b f b f  
f f f f b f f f b f  
b b b f b b b f b f  
b f f f f f b f f f  
b f b b b f b b b f  
b f f f f f f f f e  
b b b b b b b b b b  